9 9 9 9 9 9 9 9 9 9 9 9 9 9 9 9
9 3 0 0 0 1 0 0 0 1 0 0 0 0 4 9
9 2 8 8 8 2 8 8 8 2 8 8 8 8 2 9
9 2 8 8 8 2 8 8 8 5 8 1 8 8 2 9
9 5 8 8 8 0 8 8 8 0 8 2 8 8 2 9
9 2 8 8 8 8 8 8 8 8 8 5 0 8 0 9
9 2 8 8 8 8 8 8 8 8 8 2 8 8 8 8
9 5 0 0 8 8 8 8 8 1 8 0 0 0 1 9
9 2 8 8 8 8 8 8 8 2 8 8 8 8 2 9
9 2 8 8 8 8 8 8 8 2 8 8 8 8 2 9
9 0 0 0 0 0 0 0 0 0 0 0 0 0 0 9
9 9 9 9 9 9 9 9 9 9 9 9 9 9 9 9