9 9 9 9 9 9 9 9 9 9 9 9 9 9 9 9
9 3 0 0 0 0 1 0 0 1 0 0 0 0 4 9
9 2 8 8 8 8 2 8 8 2 8 8 8 8 2 9
9 2 8 8 8 8 2 8 8 2 8 8 8 8 2 9
9 5 0 0 8 0 0 0 8 0 8 1 8 0 2 9
9 2 8 8 8 8 8 8 8 8 8 2 8 8 8 9
9 2 8 8 8 8 8 8 8 8 8 2 0 0 4 9
9 5 0 0 8 0 6 8 8 8 8 8 8 8 2 9
9 2 8 8 8 8 2 8 8 8 8 8 8 8 2 9
9 2 8 8 8 8 2 8 8 8 8 8 8 8 2 9
9 0 0 0 0 0 0 0 0 0 0 0 0 0 0 9
9 9 9 9 9 9 9 9 9 9 9 9 9 9 9 9